{
"Dimensions":{"x":11,"y":9},
"PlayerPosition":{"x":2,"y":7},
"MapElements":
	[0,0,0,0,0,1,1,1,1,1,0,
	 0,0,0,0,1,1,2,2,2,1,0,
	 1,1,1,1,1,2,2,2,2,1,0,
	 1,2,3,2,3,2,1,4,1,1,1,
	 1,2,2,2,2,2,4,4,4,2,1,
	 1,1,3,1,1,1,1,4,1,2,1,
	 1,2,3,2,2,2,2,2,3,2,1,
	 1,2,5,2,1,1,1,1,1,1,1,
	 1,1,1,1,1,0,0,0,0,0,0]
}