{
"Dimensions":{"x":21,"y":13},
"PlayerPosition":{"x":12,"y":2},
"MapElements":
	[1,1,1,1,0,0,0,0,0,0,0,0,0,0,0,0,1,1,1,1,0,
	 1,2,2,1,1,1,1,1,1,1,1,1,1,1,1,1,1,2,2,1,0,
	 1,2,2,4,4,4,4,4,4,4,4,6,5,1,2,2,2,2,2,1,0,
	 1,2,2,1,1,1,1,1,1,1,1,1,3,1,2,3,1,1,2,1,0,
	 1,1,2,1,2,2,2,2,2,2,1,2,2,1,1,2,2,1,2,1,0,
	 0,1,2,1,2,2,2,2,2,2,1,2,2,2,2,2,2,1,2,1,0,
	 1,1,2,1,2,2,2,2,2,2,1,2,2,1,1,2,2,1,2,1,1,
	 1,2,2,1,1,1,1,1,1,1,1,1,1,1,1,1,1,1,2,2,1,
	 1,2,2,2,2,2,2,2,2,2,2,2,2,2,2,2,2,2,2,2,1,
	 1,2,2,1,2,1,2,1,2,1,2,1,2,1,2,1,2,1,1,1,1,
	 1,1,2,3,2,3,2,3,2,3,2,3,2,2,3,2,2,1,0,0,0,
	 0,1,1,1,1,1,1,1,1,1,1,1,1,1,1,2,2,1,0,0,0,
	 0,0,0,0,0,0,0,0,0,0,0,0,0,0,1,1,1,1,0,0,0]
}