{
"Dimensions":{"x":8,"y":5},
"PlayerPosition":{"x":4,"y":1},
"MapElements":
	[1,1,1,1,1,1,1,1,
	 1,2,4,1,5,2,2,1,
	 1,2,3,2,3,2,2,1,
	 1,4,2,2,2,1,1,1,
	 1,1,1,1,1,1,0,0]
}